NO ./texture/wall_n.xpm
SO ./texture/wall_s.xpm
EA ./texture/wall_e.xpm
WE ./texture/wall_w.xpm

F 0,255,0
C 255,0,255

11111111
10000001
1000E101
11000001
11111111
