

NO ./texture/no.xpm
C 225,30,0

EA ./texture/ea.xpm
SO ./texture/so.xpm

WE ./texture/we.xpm




F            220,100,0




            1111111111111111111111111
            1000000000110000000000001
            1011000001110000000000001
            1001000000000000000011111
111111111111100001110000000000001
100000000011000001110111111111111
11110111111111011100000010001
11110111111111011101010010001
11000000110101011100000010001
11111111111111111111111111111
11111111111111111111111111111
10000000000000000000000010001
10000000000000001101010000N01
110000011101010111110111100111
11110111 1110101 101111010001
11111111 1111111 111111111111
