NO ./texture/wall_n.xpm
SO ./texture/wall_s.xpm
EA ./texture/wall_e.xpm
WE ./texture/wall_w.xpm

F 0,255,0
C 255,0,0

11111111
10000001
1000100E1
110000011
11111111
